50
15
120 10 10 10 10 10 10 10 10 10 10 10 10 10 10 10 10 10 10 10 10 10 10 10 10 10 10 10 10 10 10 10 10 10 10 10 10 10 10 10 10 10 10 10 10 10 10 10 10 10
120 10 10 10 10 10 10 10 10 10 10 10 10 10 10 10 10 10 10 10 10 10 10 10 10 10 10 10 10 10 10 10 10 10 10 10 10 10 10 10 10 10 10 10 10 10 10 10 10 10 
120 10 10 10 10 10 10 10 10 10 10 10 10 10 10 10 10 10 10 10 10 10 10 10 10 10 10 10 10 10 10 10 10 10 10 10 10 10 10 10 10 10 10 10 10 10 10 10 10 10
120 10 10 10 10 10 10 10 10 10 10 10 10 10 10 10 10 10 10 10 10 10 10 10 10 10 10 10 10 10 10 10 10 10 10 10 10 10 10 10 10 10 10 10 10 10 10 10 10 10 
120 10 10 10 10 10 10 10 10 10 10 10 10 10 10 10 10 10 10 10 10 10 10 10 10 10 10 10 10 10 10 10 10 10 10 10 10 10 10 10 10 10 10 10 10 10 10 10 10 10
120 10 10 10 10 10 10 10 10 10 10 10 10 10 10 10 10 10 10 10 10 10 10 10 10 10 10 10 10 10 10 10 10 10 10 10 10 10 10 10 10 10 10 10 10 10 10 10 10 10
120 10 10 10 10 10 10 10 10 10 10 10 10 10 10 10 10 10 10 10 10 10 10 10 10 10 10 10 10 10 10 10 10 10 10 10 10 10 10 10 10 10 10 10 10 10 10 10 10 10
120 10 10 10 10 10 10 10 10 10 10 10 10 10 10 10 10 10 10 10 10 10 10 10 10 10 10 10 10 10 10 10 10 10 10 24 10 10 10 10 10 10 10 10 10 10 10 10 10 10
120 10 10 10 10 10 10 10 10 10 10 10 10 10 10 10 10 10 10 10 10 10 10 10 10 10 10 10 10 10 10 10 10 24 10 43 10 10 10 10 10 10 10 10 10 10 10 10 10 10
120 10 10 10 10 20 21 21 21 22 10 10 10 10 10 10 10 10 10 10 20 21 21 21 22 10 10 10 10 10 10 24 10 43 10 43 10 10 10 10 10 10 10 10 10 10 10 10 10 10
120 10 10 10 10 39 40 40 40 41 10 10 10 10 10 10 10 10 10 10 39 40 40 40 41 10 10 10 10 10 10 43 10 43 10 43 10 10 10 10 10 10 10 10 10 10 10 10 10 10
21 21 21 21 21 29 40 40 40 49 21 21 21 21 21 21 21 21 21 21 29 40 40 40 49 21 21 21 22 10 10 43 10 43 10 43 10 20 21 21 21 21 21 21 21 21 21 21 21 21
40 40 40 40 40 40 40 40 40 40 40 40 40 40 40 40 40 40 40 40 40 40 40 40 40 40 26 27 41 10 10 43 10 43 10 43 10 39 40 40 40 40 40 40 40 40 40 40 40 40
40 40 40 40 40 40 40 40 40 40 40 40 40 40 40 40 40 40 40 40 40 40 40 40 40 40 45 46 41 10 10 43 10 43 10 43 10 39 40 40 40 40 40 40 40 40 40 40 40 40
40 40 40 40 40 40 40 40 40 40 40 40 40 40 40 40 40 40 40 40 40 40 40 40 40 40 40 40 41 120 120 43 120 43 120 43 10 39 40 40 40 40 40 40 40 40 40 40 40 40
